1111111111111111111111111111111111
1E0000000000000C00000C000C00000001
101001010010000010100100000C010101
1C10010010101010001001000000010101
1P0000000C00C00000000C00000C0000C1
1111111111111111111111111111111111
